1111111111111111111111111111111111
100000000000000000000000N000000001
1111111111111111111111111111111111
1P0000000C00C000000000000C000000E1
1111111111111111111111111111111111
