1111111111111111111111111111111
1E0100C000000000000000100001001
1001011111111000111001100010001
10011100P0101000001000001000001
1000100000101011110001111001001
10001001000000100C0001000010001
1010000011111100011001000011001
1010C00001100N00001111000001001
1111111111111111111111111111111
